00000000000000000000000000000000000000000000000000000000000
01111111111111111111111111111111111111111111111111111111110
01000000010000000010000000000100000000000100000000000000010
01111111111111111111111111111111111111111111111111111111110
00101010100101010101010101010101010101010101010101010101000
01111111111111111111111111111111110111111111111111111111110
01110111411101011111111110111111110111111101111111111111110
01110111111101011111111111111101111111111101111111111111110
01111111111111111111111110111101110111111101111111111111110
01110111111101011111111110111101110111111101111111111111110
01110111111111111111111111111111110111111111111111111111110
01110111111111111111111111111101110111111111111111111111110
01111111111111111111111111111101110111111111111111111111110
01111000000000000011000100111101110111111000000000000000110
0111101111111111111103   0111101111111111111111111111110110
0111101110111111111103 3 0111101110100000000001111111110110
01111011101111111111000000111101111111111111111111111111110
01111011101111111111111111111101111111111111111111111111110
01111111101111011111111111111111111111111111111111111111110
01111111101111011111112111101010010101010101010101010101110
01111111101111011011111111111111111111111111111141111111110
01111111111111011011011111100100001000000010000010000001110
01111111111111111011011011111111111111111111111111111111110
01111110110111111011011011110111111111111111101111101111110
01111110110111111111011011010111111111111101101101101111110
01111110110111111111111011010111111111111101101101101111110
01111110110111111111111111010110111111111101101101101111110
01111110110111111111111111010110111111111111111111111111110
01111110110111000000000111110110110111111101101101101111110
01111110110111110111111111111110110111111101101101101111110
01111110110111110111111111111111110111011101101101101111110
01111110110111110001001111111111110111011101101101101111110
01111110110111111111101111111111111111101101101101101111110
01111110110111111111111111114111111110111101111101111111110
01111110110111111111101111111111111111111111111111111111110
01111110110111411111111111111111111111111111111111111111110
01111110110111111110010000100000001000001000000111111111110
01111111111111111111111111111111111111111111111111111111110
01111110101010101010110101010011010010101010101010101011110
01111111111111111111111111111111111111111111111111111111110
01111010101011010101010101010101010101101001010101111001110
01111111111111111111111111111111111111111111111111111111110
01110101010101010100101011001010101010101010110010101011110
01111111111111111111111111111111111111111111111111111111110
01111111111111111111111111111111111111111111111111111111110
01110101010011001011010010110101010100101010101010101101110
01111111111111111111111111111111111111111111111111111111110
00000000000000000000000000000000000000000000000000000000000
